die Tradition, -en - tradicija
traditionell - tradicjonalen
der Brauch -¨e - navada, šega, običaj
das Festessen - ein besonderes Essen
mit einem guten Essen - z dobrim obedom
mit Freunden - s prijatelji
mit Verwandeten - s sorodniki
mit Familie - z družino
mit Nachbarn - z sosedi
der Nachbar -n - sosed
zu Hause - doma
draußen - zunaj
im Garten - na vrtu
wir mieten einen Raum - najamemo nek prostor
der Geburtstag -e - rojstni dan
die Geburtstagsparty -s - rojstnodnevna zabava
die Grillparty -s - piknik
das Picknick -s - piknik
wir spielen Brattspiele / Gesellschaftsspiele - igramo družabne igre
schenken - podariti
das Geschenk -e - darilo
geben (gibst) - dati
bringen - prinesti
mitbrinen - prinesti s seboj
feiern - praznovati
die Feier -n - praznovanje
der Feiertag -e - praznik
alle sind/haben frei - vsi so prosti, imajo prosti
der Namenstag -e - god
gratulieren - voščiti, čestitati
Alles Gute zum/zur ... - vse najboljše za ...
Herzlichen Glückwunsch zum/zur ... - vse najboljše za...
die Taufe -n - krst
die Hochzeit -en - poroka
der Hochzeitstag -e - obletnica poroke
der Jahrestag -e - obletnica
ich lade euch ein - povabim vaju/vas
Ich lade Sie ein - povabim Vas 
die Einladung -en - vabilo
eine Einladung zum Geburtstag - vabilo na rojstni dan
zur Hochzeit - na poroko
heiraten - poročiti se
verheiratet - poročen
zur Kostümparty - na zabavo v maskah
zur Silvesterparty zur Silvesterfeier - na silvestrsko zabavo
Schwein haben - Glück haben
der Wettbewerb -e - tekmovanje
im ganzen Satz - v celem stavku
schreibe zu jedem Punkt 1 Sätze - napiši k vsaki točki 1 poved
warum? - zakaj?
denn - kajti
dann/danach - potem, zatem
Was bringst du zur party mit? - Kaj boš prinesel na zabavo?
Was tragen die leute zu einer Kostümparty? - Kaj imajo ljudje oblečemo na zabavi v maskah?
wichtig - pomemben
genauso wichtig wie - enako pomemben kot
wichtiger als - pomembnejši kot
am wichtigsten - najpomembnejši
das wichtigste Fest - najpomembnejši praznik
normalerweise - gewhnlich
Sekt und Feuerwerk gibt es an Silvester. - Peneče vino in ognjemet sta za silvestrovo.
der Sekt - peneče vino
der Champagner - šampanjec
Wann findet der Wettbewerb statt? - Kdaj je tekmovanje?
Wie feiert man? - Kako se praznuje?
Was sind für dich wichtige Feste? - Kaj so zate pomembni prazniki?
Jänner - Januar
der Nikolaustag -e - Miklavž
der Heiligabend - sveti večer 
der Stephanstag -e - Štefanovo
der Silvester - Silvestor
der Valentinstag - valentinovo
der Aschermittwoch - pepelnična sreda
die Fastenzeit -en - postni čas
der Muttertag - materinski dan
der Vatertag - očetovski dan
das Ostern - velika noč
der Karneval/der Fasching/die Fastnacht - pust
der Rosenmontag - pushtni ponedeljek
küssen - poljubiti
der Kuss -¨e - poljub
das Küsschen -/ - poljubček
lachen - smejati se
lächeln - smehljati se
die Menge -n - množica
werfen (wirst) - vreči, metati
Tonnen von - zelo veliko nečesa
aufhören/ednen - končati se
das Holz - les
sich verkleiden - našemiti se
verkleidet - našemljen
der Umzug -¨e - sprevod
der Karnevalsumzug -¨e - karnevalski sprevod
das Rheinland - reinska dežela
gewinnen - zmagati
das Osterei -er - pirh
verstecken - skriti
suchen - iskati
finden - najti
(an)klopfen - trkati
Schokoladeneier - čokoladna jajca
Schokoladenhasen - čokoladni zajci
das Sommerfest -e - poletna zabava
das Straßenfest -e - ulična zabava
überall - vsepovsod
anders, nicht gleich, unterschiedlich - različen, drugačen
der Schmuck, -/ - okrasje, nakit
schmücken - okrasiti
der Almamtrieb - kravji bal
die Alm -en -planina
das Tal -¨er - dolina
der Stall -¨e - hlev
das Feld -er - polje
sich freuen - veseliti se
das Glück - sreča
sich wünchen - želeti si
